[id][cost,state,father_id,action,depth,h,value]
[0][0,(0, 0),None,None,0,8,0]
[0][2,(1, 0),0,S,1,7,1]
[0][2,(2, 0),0,S,2,6,2]
[0][4,(3, 0),0,S,3,5,3]
[0][6,(4, 0),0,S,4,4,4]
[0][6,(4, 1),0,E,5,3,5]
[0][8,(4, 2),0,E,6,2,6]
[0][8,(4, 3),0,E,7,1,7]
[0][11,(4, 4),0,E,8,0,8]