[id][cost,state,father_id,action,depth,h,value]
[0][0,(0, 0),None,None,0,8,8]
[0][2,(1, 0),0,S,1,7,9]
[0][2,(2, 0),0,S,2,6,8]
[0][2,(2, 1),0,E,3,5,7]
[0][2,(2, 2),0,E,4,4,6]
[0][2,(2, 3),0,E,5,3,5]
[0][3,(3, 3),0,S,6,2,5]
[0][3,(4, 3),0,S,7,1,4]
[0][6,(4, 4),0,E,8,0,6]