[id][cost,state,father_id,action,depth,h,value]
[0][0,(0, 0),None,None,0,8,0]
[0][2,(1, 0),0,S,1,7,1]
[0][2,(2, 0),0,S,2,6,2]
[0][4,(3, 0),0,S,3,5,3]
[0][4,(3, 1),0,E,4,4,4]
[0][5,(3, 2),0,E,5,3,5]
[0][6,(3, 3),0,E,6,2,6]
[0][7,(3, 4),0,E,7,1,7]
[0][10,(4, 4),0,S,8,0,8]